consonant.n	form_unit
vowel.n	form_unit
letter.n	form_unit
syllable.n	form_unit
semi-consonant.n	form_unit
semiconsonant.n	form_unit
semivowel.n	form_unit
tenuis.n	form_unit
agree.v	agreement
agreement.n	agreement
voice.n	voice_property
active.n	voice_property
passive.n	voice_property
middle.n	voice_property
impersonal.n	voice_property
alveolar.n	anterior_property
dental.n	anterior_property
person.n	person_property
nasal.n	nasality_property
root.n	morpheme
stem.n	morpheme
base.n	morpheme
termination.n	morpheme
derivation.n	morpheme
numeral.n	numeral
number.n	numeral
distributive.n	numeral
cardinal.n	numeral
multiplicative.n	numeral
ordinal.n	numeral
labial.n	labial_property
denti-labial.n	labial_property
sign.n	linguistic_sign
particle.n	particle
accent.n	tone_property
tone.n	tone_property
pitch.n	tone_property
derivation.n	derivational_morpheme
clause.n	clause
dual.n	number_property
number.n	number_property
plural.n	number_property
singular.n	number_property
character.n	character
nasalize.v	nasalization
nasalization.n	nasalization
inflected.a	inflection
conjugate.v	inflection
conjugated.a	inflection
declined.a	inflection
decline.v	inflection
demonstrative.n	pronominal
pronoun.n	pronominal
copula.n	verbal
auxiliary.n	verbal
verb.n	verbal
intransitive.n	verbal
transitive.n	verbal
article.n	article
affix.v	affixation
affixed.a	affixation
infix.v	affixation
infixed.a	affixation
postfixed.a	affixation
prefix.v	affixation
suffix.v	affixation
suffixed.a	affixation
prefixed.a	affixation
conjugate.v	affixation
conjugated.a	affixation
derived.a	derivation
changed.a	derivation
transform.v	derivation
take.v	derivation
phonology.n	phonological_system
variety.n	linguistic_system
speech.n	linguistic_system
standard.n	linguistic_system
language.n	linguistic_system
grammar.n	linguistic_system
negation.n	polarity_property
negative.n	polarity_property
gender.n	gender_property
feminine.n	gender_property
neuter.n	gender_property
masculine.n	gender_property
aspirate.v	aspiration
disaspirate.v	aspiration
aspiration.n	aspiration
