consonant	n	fr_form_unit
vowel	n	fr_form_unit
letter	n	fr_form_unit
syllable	n	fr_form_unit
semi-consonant	n	fr_form_unit
semiconsonant	n	fr_form_unit
semivowel	n	fr_form_unit
tenuis	n	fr_form_unit
agree	v	fr_agreement
agreement	n	fr_agreement
voice	n	fr_voice_property
active	n	fr_voice_property
passive	n	fr_voice_property
middle	n	fr_voice_property
impersonal	n	fr_voice_property
alveolar	n	fr_anterior_property
dental	n	fr_anterior_property
person	n	fr_person_property
nasal	n	fr_nasality_property
root	n	fr_morpheme
stem	n	fr_morpheme
base	n	fr_morpheme
termination	n	fr_morpheme
derivation	n	fr_morpheme
numeral	n	fr_numeral
number	n	fr_numeral
distributive	n	fr_numeral
cardinal	n	fr_numeral
multiplicative	n	fr_numeral
ordinal	n	fr_numeral
labial	n	fr_labial_property
denti-labial	n	fr_labial_property
sign	n	fr_linguistic_sign
particle	n	fr_particle
accent	n	fr_tone_property
tone	n	fr_tone_property
pitch	n	fr_tone_property
derivation	n	fr_derivational_morpheme
clause	n	fr_clause
dual	n	fr_number_property
number	n	fr_number_property
plural	n	fr_number_property
singular	n	fr_number_property
character	n	fr_character
nasalize	v	fr_nasalization
nasalization	n	fr_nasalization
inflected	a	fr_inflection
conjugate	v	fr_inflection
conjugated	a	fr_inflection
declined	a	fr_inflection
decline	v	fr_inflection
demonstrative	n	fr_pronominal
pronoun	n	fr_pronominal
copula	n	fr_verbal
auxiliary	n 	fr_verbal
verb	n	fr_verbal
intransitive	n	fr_verbal
transitive	n	fr_verbal
article	n	fr_article
affix	v	fr_affixation
affixed	a	fr_affixation
infix	v	fr_affixation
infixed	a	fr_affixation
postfixed	a	fr_affixation
prefix	v	fr_affixation
suffix	v	fr_affixation
suffixed	a	fr_affixation
prefixed	a	fr_affixation
conjugate	v	fr_affixation
conjugated	a	fr_affixation
derived	a	fr_derivation
changed	a	fr_derivation
transform	v	fr_derivation
take	v	fr_derivation
phonology	n	fr_phonological_system
variety	n	fr_linguistic_system
speech	n	fr_linguistic_system
standard	n	fr_linguistic_system
language	n	fr_linguistic_system
grammar	n	fr_linguistic_system
negation	n	fr_polarity_property
negative	n	fr_polarity_property
gender	n 	fr_gender_property
feminine	n	fr_gender_property
neuter	n 	fr_gender_property
masculine	n	fr_gender_property
aspirate	v	fr_aspiration
disaspirate	v	fr_aspiration
aspiration	n	fr_aspiration
unaspirate		fr_aspiration
disaspiration	n	fr_aspiration
postposition	n	fr_adposition
preposition	n	fr_adposition
adjective	n	fr_adjectival
comparative	n	fr_adjectival
positive	n	fr_adjectival
superlative	n	fr_adjectival
noun	n	fr_noun
gerund	n	fr_noun
form	v	fr_formation
build	v	fr_formation
create	v	fr_formation
past	n	fr_tense_property
present	n	fr_tense_property
future	n	fr_tense_property
habitual	n	fr_tense_property
tense	n	fr_tense_property
suffix	n	fr_affix
infix	n	fr_affix
prefix	n	fr_affix
orthography	n	fr_orthographic_system
enclitic	n	fr_clitic
construction	n	fr_syntactic_construction
meaning	n	fr_semantic_unit
signification	n	fr_semantic_unit
sense	n	fr_semantic_unit
consonant	n	fr_segment
vowel	n	fr_segment
conjugation	n	fr_bound_morpheme
declension	n	fr_bound_morpheme
inflection	n	fr_bound_morpheme
inflexion	n	fr_bound_morpheme
mood	n 	fr_mood_property
optative	n	fr_mood_property
indicative	n	fr_mood_property
imperative	n	fr_mood_property
subjunctive	n	fr_mood_property
ablative	n 	fr_case_property
dative	n	fr_case_property
genitive	n	fr_case_property
instrumental	n	fr_case_property
locative	n	fr_case_property
nominative	n	fr_case_property
oblique	n	fr_case_property
terminative	n	fr_case_property
vocative	n	fr_case_property
objective	n	fr_case_property
agent	n	fr_case_property
obl	n	fr_case_property
case	n	fr_case_property
phrase	n	fr_phrase
conjugate	v	fr_conjugation
agree	v	fr_conjugation
inflected	a	fr_conjugation
change	v	fr_conjugation
marked	a	fr_conjugation
conjugated	a	fr_conjugation
take	v	fr_conjugation
follow	v	frm_sequence
order	n	frm_sequence
precede	v	frm_sequence
put	v	frm_sequence
succession	v	frm_sequence
